"filename", "language", "Java", "Markdown", "comment", "blank", "total"
"/Users/yizhengxie/Documents/GitHub/CS611_MosterHero/Armory.java", "Java", 13, 0, 2, 5, 20
"/Users/yizhengxie/Documents/GitHub/CS611_MosterHero/AttackBehavior.java", "Java", 4, 0, 0, 2, 6
"/Users/yizhengxie/Documents/GitHub/CS611_MosterHero/Attackable.java", "Java", 3, 0, 1, 1, 5
"/Users/yizhengxie/Documents/GitHub/CS611_MosterHero/Board.java", "Java", 67, 0, 7, 11, 85
"/Users/yizhengxie/Documents/GitHub/CS611_MosterHero/CanBeAttacked.java", "Java", 4, 0, 0, 1, 5
"/Users/yizhengxie/Documents/GitHub/CS611_MosterHero/Cell.java", "Java", 39, 0, 5, 7, 51
"/Users/yizhengxie/Documents/GitHub/CS611_MosterHero/ColorString.java", "Java", 31, 0, 3, 3, 37
"/Users/yizhengxie/Documents/GitHub/CS611_MosterHero/Equitable.java", "Java", 3, 0, 0, 1, 4
"/Users/yizhengxie/Documents/GitHub/CS611_MosterHero/Factory.java", "Java", 9, 0, 0, 2, 11
"/Users/yizhengxie/Documents/GitHub/CS611_MosterHero/Fightable.java", "Java", 2, 0, 0, 2, 4
"/Users/yizhengxie/Documents/GitHub/CS611_MosterHero/FileIO.java", "Java", 54, 0, 2, 7, 63
"/Users/yizhengxie/Documents/GitHub/CS611_MosterHero/Hero.java", "Java", 78, 0, 9, 19, 106
"/Users/yizhengxie/Documents/GitHub/CS611_MosterHero/IO.java", "Java", 73, 0, 0, 7, 80
"/Users/yizhengxie/Documents/GitHub/CS611_MosterHero/Item.java", "Java", 29, 0, 2, 6, 37
"/Users/yizhengxie/Documents/GitHub/CS611_MosterHero/LegendsGame.java", "Java", 161, 0, 15, 8, 184
"/Users/yizhengxie/Documents/GitHub/CS611_MosterHero/Market.java", "Java", 45, 0, 28, 11, 84
"/Users/yizhengxie/Documents/GitHub/CS611_MosterHero/Monster.java", "Java", 28, 0, 5, 6, 39
"/Users/yizhengxie/Documents/GitHub/CS611_MosterHero/NamedCreator.java", "Java", 26, 0, 6, 8, 40
"/Users/yizhengxie/Documents/GitHub/CS611_MosterHero/NormalAttack.java", "Java", 18, 0, 1, 8, 27
"/Users/yizhengxie/Documents/GitHub/CS611_MosterHero/Paladins.java", "Java", 9, 0, 3, 5, 17
"/Users/yizhengxie/Documents/GitHub/CS611_MosterHero/Player.java", "Java", 46, 0, 2, 8, 56
"/Users/yizhengxie/Documents/GitHub/CS611_MosterHero/Potion.java", "Java", 20, 0, 2, 4, 26
"/Users/yizhengxie/Documents/GitHub/CS611_MosterHero/README.md", "Markdown", 0, 44, 0, 25, 69
"/Users/yizhengxie/Documents/GitHub/CS611_MosterHero/RandomCreator.java", "Java", 104, 0, 37, 13, 154
"/Users/yizhengxie/Documents/GitHub/CS611_MosterHero/Sorcerers.java", "Java", 9, 0, 2, 5, 16
"/Users/yizhengxie/Documents/GitHub/CS611_MosterHero/Spell.java", "Java", 17, 0, 1, 6, 24
"/Users/yizhengxie/Documents/GitHub/CS611_MosterHero/SpellAttack.java", "Java", 24, 0, 1, 7, 32
"/Users/yizhengxie/Documents/GitHub/CS611_MosterHero/SpellFire.java", "Java", 16, 0, 2, 6, 24
"/Users/yizhengxie/Documents/GitHub/CS611_MosterHero/SpellIce.java", "Java", 12, 0, 1, 3, 16
"/Users/yizhengxie/Documents/GitHub/CS611_MosterHero/SpellLighting.java", "Java", 12, 0, 1, 3, 16
"/Users/yizhengxie/Documents/GitHub/CS611_MosterHero/TypedCreator.java", "Java", 26, 0, 6, 9, 41
"/Users/yizhengxie/Documents/GitHub/CS611_MosterHero/Useable.java", "Java", 4, 0, 4, 1, 9
"/Users/yizhengxie/Documents/GitHub/CS611_MosterHero/Warriors.java", "Java", 9, 0, 1, 5, 15
"/Users/yizhengxie/Documents/GitHub/CS611_MosterHero/Weapon.java", "Java", 26, 0, 2, 10, 38
"/Users/yizhengxie/Documents/GitHub/CS611_MosterHero/WeaponAttack.java", "Java", 20, 0, 1, 6, 27
"/Users/yizhengxie/Documents/GitHub/CS611_MosterHero/inputTest.java", "Java", 18, 0, 0, 0, 18
"Total", "-", 1059, 44, 152, 231, 1486